                         
F                         E
D                         C
D                        1C
D                     IIIIC
D                         C
D                 IIIIIIIIC
D                         C
D             IIIIIIIIIIIIC
D                         C
D          IIIIIIIIIIIIIIIC
D                         C
D     I            I      C
D     I        1   I      C
D     IIIIIIIIIIIIII      C
D                         C
D                         C
D        o o 1 o o        C
HBBBBBBBBBBBBBBBBBBBBBBBBBG
AAAAAAAAAAAAAAAAAAAAAAAAAAA