                                                                        KKKKKKKKKKKKKKKKKKKKKKKKKKKKKKKKKKKKKKKKKKKKKKKKKKKKKKKKKKKKKKKKKKKKKKKKKKKKKKKKKKKKKKKKKKKKKKKKKKKKKKKKKKKKKKKKKKKKKKKKKKKKKKKKKKKKKKKKKKKKKKKKKKKKKKKK               
                                                                                                 ooo          oo                                                                                                                             EB
F                                                                        KKKKKKK                 o  o        o  o                                                                                                                     I      CA
D                                                                              K                 ooo         o  o            ooo        oo              ST                                                                                  ICA
D                                            oo   KKKKKKK                      K                 o o         o  o            o  o      o  o             QR                                                                                   CA
D                                          oo     K     KKKKKKKKKKKKKKKKK      K                 o  o         oo             ooo       oooo          KKKKKKKK       2            2                                                           CA
D                                        oo       K  o     o  o  o  o  o  o  o K                IIIIII      IIIIII           o o       o  o       KKKKKKKKKKKKKK                                                                            ICA
HBBBBBBF                                o         K o o   o  o  o  o  o  o  o  K                                             o  o      o  o    KKKKKKKKKKKKKKKKKKKK    1         1                            K     K                        CA
AAAAAAAD                               o          K  u  KKKKKKKKKKKKKKKKKKKKKKKK       IIIII                              KKKKKKKKKKKKKKKKKKKKKKKKKKKKKKKKKKKKKKKKKKKKKKKKKKKKKKKKKKKK                    KKKK   *   KKK                     CA
AAAAAAAD  o                            o          KKKKKKK             oo                              UV                                                                                                    KK       KK        KKK       OP  CA
AAAAAAAD o o                                                         o  o            o  o           UVWX                                                                1          1                         KKKKKKKKK                   MN  CA
AAAAAAAD  o                     o                                    oooo            o  o           WXWXUV                                                       IIIIIIIIIIIIIIIIIIIIIIIIIII                                             MN  CA
AAAAAAAHBBBBF                  o o                                   o  o            o  o       EBBBBBBBBBBBBBBF                                                                                                                 o    EBBBBBBGA
AAAAAAAAAAAAD                 o o o                                  o  o            o  o       CAAAAAAAAAAAAAAD                                       ST                                   oo       8                          o o   CAAAAAAAA
AAAAAAAAAAAAD               IIIIIIIII                            EBBBBBBBBBBBF        oo        CAAAAAAAAAAAAAAD              oo                       QRST                               oo  oo8                                 %   CAAAAAAAA
AAAAAAAAAAAAD  ST                                         ST o o CAAAAAAAAAAAD    @   @   @     CAAAAAAAAAAAAAAHBBBBBBF      oooo           UV     OP  QRQRST                          8oo  oo  oo                            EBBBBBBBGAAAAAAAA
AAAAAAAAAAAAD  QR                           EBBBF        YQR  o  CAAAAAAAAAAAHBBBBBBBBBBBBBBBBBBGAAAAAAAAAAAAAAAAAAAAAD      oooo           WXY    MN  QRQRQRST                 8     oo  oo  oo  oo                          CAAAAAAAAAAAAAAAA
AAAAAAAAAAAAD  QR          %    %    %      CAAAD       YZQR o7o CAAAAAAAAAAAAAAAAAAAAAAAAAAAAAAAAAAAAAAAAAAAAAAAAAAAAD    $  oo  $   $     WXZY   MN  QRQRQRQRST        8                                   %     %          CAAAAAAAAAAAAAAAA
AAAAAAAAAAAAHBBBBBBBBBBBBBBBBBBBBBBBBBBBBBBBGAAAHBBBBBBBBBBBBBBBBGAAAAAAAAAAAAAAAAAAAAAAAAAAAAAAAAAAAAAAAAAAAAAAAAAAAAHBBBBBBBBBBBBBBBBBBBBBBBBBBBBBBBBBBBBBBBBBBBBBBBBBBBBBBBBBBBBBBBBBBBBBBBBBBBBBBBBBBBBBBBBBBBBBBBBBBBBBBBGAAAAAAAAAAAAAAAA
AAAAAAAAAAAAAAAAAAAAAAAAAAAAAAAAAAAAAAAAAAAAAAAAAAAAAAAAAAAAAAAAAAAAAAAAAAAAAAAAAAAAAAAAAAAAAAAAAAAAAAAAAAAAAAAAAAAAAAAAAAAAAAAAAAAAAAAAAAAAAAAAAAAAAAAAAAAAAAAAAAAAAAAAAAAAAAAAAAAAAAAAAAAAAAAAAAAAAAAAAAAAAAAAAAAAAAAAAAAAAAAAAAAAAAAAAAAAAAA