                                                                        KKKKKKKKKKKKKKKKKKKKKKKKKKKKKKKKKKKKKKKKKKKKKKKKKKKKKKKKKKKKKKKKKKKKKKKKKKKKKKKKKKKKKKKKKKKKKKKKKKKKKKKKKKKKKKKKKKKKKKKKKKKKKKKKKKKKKKKKKKKKKKKKKKKKKKKK               
                                                                                                  oo                                                                                                                                         EB
F                                                                        KKKKKKK                 o  o                                                                                                                                 I      CA
D                                                                              K                 oooo                                   o               ST               ooo                                                                ICA
D                                            oo   KKKKKKK                      K                 o  o                                   o               QR               o  o                                                                CA
D                                          oo     K     KKKKKKKKKKKKKKKKK      K                 o  o       IIIIIII             2       o     2      KKKKKKKK       2    o  o    2                                                           CA
D                                        oo       K  o     o  o  o  o  o  o  o K                IIIIII                                  o         KKKKKKKKKKKKKK         o  o                                                               ICA
HBBBBBBF                                o         K o o   o  o  o  o  o  o  o  K                                                   1    o  1   KKKKKKKKKKKKKKKKKKKK    1 ooo     1                            K     K                        CA
AAAAAAAD                               o          K  u  KKKKKKKKKKKKKKKKKKKKKKKK       IIIII                              KKKKKKKKKKKKKKKKKKKKKKKKKKKKKKKKKKKKKKKKKKKKKKKKKKKKKKKKKKKK                    KKKK   *   KKK                     CA
AAAAAAAD  o                            o          KKKKKKK                                             UV                                                                                                    KK       KK        KKK       OP  CA
AAAAAAAD o o                                                                         ooo            UVWX                                                                1          1                         KKKKKKKKK                   MN  CA
AAAAAAAD  o                     o                                                    o  o           WXWXUV                                                       IIIIIIIIIIIIIIIIIIIIIIIIIII                                             MN  CA
AAAAAAAHBBBBF                  o o                                                   o  o       EBBBBBBBBBBBBBBF                                                                                                                 o    EBBBBBBGA
AAAAAAAAAAAAD                 o o o                                                  o  o       CAAAAAAAAAAAAAAD             o  o                      ST                                   oo       8                          o o   CAAAAAAAA
AAAAAAAAAAAAD               IIIIIIIII                            EBBBBBBBBBBBF       ooo        CAAAAAAAAAAAAAAD             o  o                      QRST                               oo  oo8                                 %   CAAAAAAAA
AAAAAAAAAAAAD  ST                                         ST o o CAAAAAAAAAAAD    @   @   @     CAAAAAAAAAAAAAAHBBBBBBF      o  o           UV     OP  QRQRST                          8oo  oo  oo                            EBBBBBBBGAAAAAAAA
AAAAAAAAAAAAD  QR                           EBBBF        YQR  o  CAAAAAAAAAAAHBBBBBBBBBBBBBBBBBBGAAAAAAAAAAAAAAAAAAAAAD      o  o           WXY    MN  QRQRQRST                 8     oo  oo  oo  oo                          CAAAAAAAAAAAAAAAA
AAAAAAAAAAAAD  QR          %    %    %      CAAAD       YZQR o7o CAAAAAAAAAAAAAAAAAAAAAAAAAAAAAAAAAAAAAAAAAAAAAAAAAAAAD    $  oo  $   $     WXZY   MN  QRQRQRQRST        8                                   %     %          CAAAAAAAAAAAAAAAA
AAAAAAAAAAAAHBBBBBBBBBBBBBBBBBBBBBBBBBBBBBBBGAAAHBBBBBBBBBBBBBBBBGAAAAAAAAAAAAAAAAAAAAAAAAAAAAAAAAAAAAAAAAAAAAAAAAAAAAHBBBBBBBBBBBBBBBBBBBBBBBBBBBBBBBBBBBBBBBBBBBBBBBBBBBBBBBBBBBBBBBBBBBBBBBBBBBBBBBBBBBBBBBBBBBBBBBBBBBBBBBGAAAAAAAAAAAAAAAA
AAAAAAAAAAAAAAAAAAAAAAAAAAAAAAAAAAAAAAAAAAAAAAAAAAAAAAAAAAAAAAAAAAAAAAAAAAAAAAAAAAAAAAAAAAAAAAAAAAAAAAAAAAAAAAAAAAAAAAAAAAAAAAAAAAAAAAAAAAAAAAAAAAAAAAAAAAAAAAAAAAAAAAAAAAAAAAAAAAAAAAAAAAAAAAAAAAAAAAAAAAAAAAAAAAAAAAAAAAAAAAAAAAAAAAAAAAAAAAA