#######################################################################################################################################################################################################################################################
####                                                                                                                                                                                                                                                  #
####u                                                                                                                                                                                                                                                 #
BBBBF                                                                                                                                                                                                                                                 #
AAAAD        K    K                                                                                                                                                                                                                                   #
AAAAD      KKKKKKKK                                                                                                                                     2                      K          KKKKKKKKKKKKKKKK                 *    EBBBBBBBBBBBBBBBBBBBBBB
AAAAD                        KKKKKKKK                                                                                                                                     I                             KKKKKKKK                CAAAAAAAAAAAAAAAAAAAAAA
AAAAD                               KKKKKK                                                                                                                                                                    KKKKKKKKKK        CAAAAAAAAAAAAAAAAAAAAAA
AAAAD                                    KKKKKKK                                                                                                                   IIII                                       KKKKKKKKKKEBBBBBBBGAAAAAAAAAAAAAAAAAAAAAA
AAAAD                                          KKKKKKK                             o o o o o o o                                                              I                          8                              CAAAAAAAAAAAAAAAAAAAAAAAAAAAAAA
AAAAD                                                                                                          ST                                                                    8                                  CAAAAAAAAAAAAAAAAAAAAAAAAAAAAAA
AAAAD                                           o o o o o o o    3                    5      5                YQRST                                      UV                       8                                     CAAAAAAAAAAAAAAAAAAAAAAAAAAAAAA
AAAAD                                   IIIIIIIIIIIIIIIIIIIIIIIIIIII        KKKKKKKKKKKKKKKKKKKKKKKKKKK       ZQRQR    1   1                         I   WX   I                8                                        CAAAAAAAAAAAAAAAAAAAAAAAAAAAAAA
AAAAD                               IIIIIIII                                          o            KKKKKKKKKKKKKKKKKKKKKKKKKKKKK                      1  WX                                                   ST o o o oCAAAAAAAAAAAAAAAAAAAAAAAAAAAAAA
AAAAD                          IIIIIIII                                              o o                                                           EBBBBBBBBBBBBF                                             QRSTo o o CAAAAAAAAAAAAAAAAAAAAAAAAAAAAAA
AAAAD        IIIIIIIIIIIIIIIIIIIIIII                     OP                         o o o                                2                     Io  CAAAAAAAAAAAAD                                            YQRQR o o oCAAAAAAAAAAAAAAAAAAAAAAAAAAAAAA
AAAAD                                                    MNOP                        o o                              o o o o                  o o CAAAAAAAAAAAAHBBBBBF                                      ZQRQRY o o CAAAAAAAAAAAAAAAAAAAAAAAAAAAAAA
AAAAD      I                            o o o       I    MNMN                         o                                                      EBBBBBGAAAAAAAAAAAAAAAAAAHBBBBF                       IIII      ZQRQRZY o oCAAAAAAAAAAAAAAAAAAAAAAAAAAAAAA
AAAAD            1        1            o o o o           MNMN                    4       4       4       4                                   CAAAAAAAAAAAAAAAAAAAAAAAAAAAAAHBF         3    4    5    6      ZQRQRZZo o CAAAAAAAAAAAAAAAAAAAAAAAAAAAAAA
AAAAHBBBBBBBBBBBBBBBBBBBBBBBBBBBBBBBBBBBBBBBBBBBBBBBBBBBBBBBBBBBBBBBBBBBBBBBBBBBBBBBBBBBBBBBBBBBBBBBBBBBBBBBBBBBBBBBBBBBBBBBBBBBBBBBBBBBBBBBBGAAAAAAAAAAAAAAAAAAAAAAAAAAAAAAAHBBBBBBBBBBBBBBBBBBBBBBBBBBBBBBBBBBBBBBBBBBGAAAAAAAAAAAAAAAAAAAAAAAAAAAAAA
AAAAAAAAAAAAAAAAAAAAAAAAAAAAAAAAAAAAAAAAAAAAAAAAAAAAAAAAAAAAAAAAAAAAAAAAAAAAAAAAAAAAAAAAAAAAAAAAAAAAAAAAAAAAAAAAAAAAAAAAAAAAAAAAAAAAAAAAAAAAAAAAAAAAAAAAAAAAAAAAAAAAAAAAAAAAAAAAAAAAAAAAAAAAAAAAAAAAAAAAAAAAAAAAAAAAAAAAAAAAAAAAAAAAAAAAAAAAAAAAAAAAAAA
AAAAAAAAAAAAAAAAAAAAAAAAAAAAAAAAAAAAAAAAAAAAAAAAAAAAAAAAAAAAAAAAAAAAAAAAAAAAAAAAAAAAAAAAAAAAAAAAAAAAAAAAAAAAAAAAAAAAAAAAAAAAAAAAAAAAAAAAAAAAAAAAAAAAAAAAAAAAAAAAAAAAAAAAAAAAAAAAAAAAAAAAAAAAAAAAAAAAAAAAAAAAAAAAAAAAAAAAAAAAAAAAAAAAAAAAAAAAAAAAAAAAAAA