13x25
R....O....Y.GBG..B....P..
ORR.OYO.YYG..G...B....R..
R....O....Y..G..BPB..PPP.
R.....O.....Y.....G...P..
ORRR.OYOO.YYGY.GGGB......
R.....O.....Y.....G...P..
ROR..O...Y...G.......PPP.
.R..OYO..Y...G...P....R..
.R...O..YGY..G..PPRP..P..
.R...O...Y..GBG..P.......
.R...OYOO.YYGY...G....P..
.R....O.....Y....G..PRPP.
RORR..O.....Y..GGBG...P..