16x25
R....O....Y.GBG..B....P..
ORR.OYO.YYG..G...B....R..
R....O....Y..G..BPB..PPP.
......................P..
R.....O.....Y.....G......
ORRR.OYOO.YYGY.GGGB......
R.....O.....Y.....G...P..
.....................PPP.
ROR..O...Y...G........R..
.R..OYO..Y...G...P....P..
.R...O..YGY..G..PPRP.....
.R...O...Y..GBG..P.......
.........................
.R...OYOO.YYGY...G....P..
.R....O.....Y....G..PRPP.
RORR..O.....Y..GGBG...P..